1111111111111
1M000000C00P1
10M0000C00001
1000000000001
10E000C000001
1111111111111