1111111111111
10C01000000P1
1C000M1011C01
1E1011C0000M1
1111111111111