1111111111111
1M000000C00P1
1000000C00001
1000000000001
10E000C000001
1111111111111