1111111111111
100000M0C00P1
100000MC00U01
10000000000M1
10E000C0000M1
1111111111111