1111111111111
1M000000000P1
100000MC00001
1000000000001
10E000C000001
1111111111111