1111111111111
10C01000000P1
10M0001111C01
1E1011C000M01
1111111111111