1111111111111
1000100000E01
1P10001111C01
1010110000001
1111111111111