1111111111111
1000100000EC1
1010001111001
1P10110000001
1111111111111