1111111111111
1000100001E01
101000C111101
1P10110000001
1111111111111