1111111111111
10000000000P1
1000000C00001
1000000000001
1000000000001
1000000000001
1000000000001
1000000000001
1000000000001
1000000000001
10E000C000001
1111111111111