1111111111111
10C01000000E1
1P00001111C01
101011C000001
1111111111111