1111111111111
10C01000000P1
1000001111C01
1E1011C000001
1111111111111